111111111111111111111111111111111111111111111
10000000000000000000000000000C000000000000001
1P0000000011111111100001111111111111110000001
100000000111111111100011111111111111111100C01
100000001111111111100011111111111111111110001
100000011111111111100011111110000011111110001
1000001111110111111000000000C0000011111110001
1000011111100111111000C0000000000011111110001
100011111100011111100000000000011111111100001
100111111111111111111000001111111111111000001
10011111111111111111100111111111110000000C001
100000000000011111100011111110000000000000001
10000000000001111110C011111110000000000000001
100000000000011111100011111110000000111111001
100000C00001111111111011111111111111111111001
100000000001111111111011111111111111111111001
100000000001111111111011111111111111111111001
1000000C000000000000000000000C0000000000000E1
111111111111111111111111111111111111111111111